side,entry,exit,ticks,result,duration_sec,start_time,end_time
BUY,25378.75,25373.75,-20,LOSS,250,1759967696,1759967946
BUY,25374,25379.0,20,WIN,44,1759967946,1759967990
BUY,25379,25374.0,-20,LOSS,35,1759967990,1759968025
BUY,25373.75,25368.75,-20,LOSS,182,1759968025,1759968207
BUY,25368.5,25373.5,20,WIN,218,1759968207,1759968425
BUY,25373.5,25368.5,-20,LOSS,312,1759968425,1759968737
BUY,25368.5,25363.5,-20,LOSS,304,1759968737,1759969041
BUY,25362.5,25357.5,-20,LOSS,21,1759969041,1759969062
BUY,25357.5,25362.5,20,WIN,27,1759969062,1759969089
BUY,25362.75,25367.75,20,WIN,1362,1759969089,1759970451
BUY,25368,25363.0,-20,LOSS,319,1759970451,1759970770
BUY,25362.75,25357.75,-20,LOSS,894,1759970770,1759971664
BUY,25358.25,25363.25,20,WIN,12,1759971664,1759971676
BUY,25364.5,25369.5,20,WIN,41,1759971676,1759971717
BUY,25367.75,25362.75,-20,LOSS,250,1759971717,1759971967
BUY,25362.75,25357.75,-20,LOSS,151,1759971967,1759972118
BUY,25357,25352.0,-20,LOSS,220,1759972118,1759972338
BUY,25352.5,25347.5,-20,LOSS,77,1759972338,1759972415
BUY,25347.75,25342.75,-20,LOSS,36,1759972415,1759972451
BUY,25341,25336.0,-20,LOSS,13,1759972451,1759972464
BUY,25334,25329.0,-20,LOSS,37,1759972464,1759972501
BUY,25329.5,25334.5,20,WIN,29,1759972501,1759972530
BUY,25335,25330.0,-20,LOSS,24,1759972530,1759972554
BUY,25330,25335.0,20,WIN,67,1759972554,1759972621
BUY,25335.25,25340.25,20,WIN,504,1759972621,1759973125
BUY,25340.75,25345.75,20,WIN,69,1759973125,1759973194
BUY,25345.75,25340.75,-20,LOSS,171,1759973194,1759973365
BUY,25341.75,25336.75,-20,LOSS,62,1759973365,1759973427
BUY,25337,25332.0,-20,LOSS,91,1759973427,1759973518
BUY,25332.5,25327.5,-20,LOSS,91,1759973518,1759973609
BUY,25327.5,25322.5,-20,LOSS,29,1759973609,1759973638
BUY,25324.25,25329.25,20,WIN,90,1759973638,1759973728
BUY,25329.25,25324.25,-20,LOSS,353,1759973728,1759974081
BUY,25324.25,25329.25,20,WIN,210,1759974081,1759974291
BUY,25328.75,25333.75,20,WIN,462,1759974291,1759974753
BUY,25334,25329.0,-20,LOSS,111,1759974753,1759974864
BUY,25329,25324.0,-20,LOSS,691,1759974864,1759975555
BUY,25323,25328.0,20,WIN,531,1759975555,1759976086
BUY,25328,25323.0,-20,LOSS,211,1759976086,1759976297
BUY,25322.75,25327.75,20,WIN,166,1759976297,1759976463
BUY,25328.25,25323.25,-20,LOSS,145,1759976463,1759976608
BUY,25324,25329.0,20,WIN,126,1759976608,1759976734
BUY,25329.5,25334.5,20,WIN,58,1759976734,1759976792
BUY,25333.75,25328.75,-20,LOSS,32,1759976792,1759976824
BUY,25328.5,25333.5,20,WIN,377,1759976824,1759977201
BUY,25332.5,25337.5,20,WIN,13,1759977201,1759977214
BUY,25336.25,25331.25,-20,LOSS,123,1759977214,1759977337
BUY,25331.5,25326.5,-20,LOSS,77,1759977337,1759977414
BUY,25326.5,25321.5,-20,LOSS,155,1759977414,1759977569
BUY,25321.5,25316.5,-20,LOSS,675,1759977569,1759978244
BUY,25316.5,25311.5,-20,LOSS,47,1759978244,1759978291
BUY,25309.75,25314.75,20,WIN,107,1759978291,1759978398
BUY,25314.75,25309.75,-20,LOSS,147,1759978398,1759978545
BUY,25309.5,25314.5,20,WIN,36,1759978545,1759978581
BUY,25314.5,25309.5,-20,LOSS,34,1759978581,1759978615
BUY,25309.5,25314.5,20,WIN,197,1759978615,1759978812
BUY,25314.5,25319.5,20,WIN,412,1759978812,1759979224
BUY,25319.5,25324.5,20,WIN,641,1759979224,1759979865
BUY,25324.5,25329.5,20,WIN,287,1759979865,1759980152
BUY,25331.25,25336.25,20,WIN,1,1759980152,1759980153
BUY,25335,25340.0,20,WIN,1,1759980153,1759980154
BUY,25337,25342.0,20,WIN,18,1759980154,1759980172
BUY,25336.25,25331.25,-20,LOSS,28,1759980223,1759980251
BUY,25332,25327.0,-20,LOSS,74,1759980251,1759980325
BUY,25326.5,25321.5,-20,LOSS,55,1759980325,1759980380
BUY,25320.5,25325.5,20,WIN,476,1759980380,1759980856
BUY,25325.75,25330.75,20,WIN,91,1759980856,1759980947
BUY,25330.25,25325.25,-20,LOSS,1223,1759980947,1759982170
BUY,25325.25,25330.25,20,WIN,1305,1759982170,1759983475
BUY,25330,25335.0,20,WIN,86,1759983475,1759983561
BUY,25335,25340.0,20,WIN,447,1759983561,1759984008
BUY,25338,25333.0,-20,LOSS,130,1759984078,1759984208
BUY,25333,25328.0,-20,LOSS,364,1759984208,1759984572
BUY,25328,25333.0,20,WIN,291,1759984572,1759984863
BUY,25333,25338.0,20,WIN,887,1759984863,1759985750
BUY,25338,25343.0,20,WIN,441,1759985750,1759986191
BUY,25341.5,25346.5,20,WIN,359,1759986248,1759986607
BUY,25348.5,25353.5,20,WIN,1012,1759986740,1759987752
BUY,25359.5,25354.5,-20,LOSS,245,1759987863,1759988108
BUY,25354,25359.0,20,WIN,50,1759988108,1759988158
BUY,25359.25,25354.25,-20,LOSS,493,1759988158,1759988651
BUY,25353.25,25348.25,-20,LOSS,79,1759988651,1759988730
BUY,25348.25,25343.25,-20,LOSS,178,1759988730,1759988908
BUY,25344,25349.0,20,WIN,323,1759988908,1759989231
BUY,25349.75,25344.75,-20,LOSS,73,1759989231,1759989304
BUY,25345.5,25350.5,20,WIN,116,1759989304,1759989420
BUY,25350.5,25355.5,20,WIN,176,1759989420,1759989596
BUY,25355.5,25360.5,20,WIN,217,1759989596,1759989813
BUY,25358.75,25363.75,20,WIN,92,1759989818,1759989910
BUY,25363.75,25358.75,-20,LOSS,208,1759990109,1759990317
BUY,25358.75,25363.75,20,WIN,116,1759990317,1759990433
BUY,25363.5,25358.5,-20,LOSS,344,1759990438,1759990782
BUY,25358.75,25353.75,-20,LOSS,100,1759990782,1759990882
BUY,25354.25,25349.25,-20,LOSS,353,1759990882,1759991235
BUY,25349.25,25354.25,20,WIN,228,1759991235,1759991463
BUY,25354.25,25349.25,-20,LOSS,167,1759991463,1759991630
BUY,25349.25,25354.25,20,WIN,267,1759991630,1759991897
BUY,25353.75,25358.75,20,WIN,241,1759991897,1759992138
BUY,25358.25,25353.25,-20,LOSS,104,1759992138,1759992242
BUY,25353.25,25348.25,-20,LOSS,276,1759992242,1759992518
BUY,25348.25,25343.25,-20,LOSS,29,1759992518,1759992547
BUY,25343.25,25338.25,-20,LOSS,18,1759992547,1759992565
BUY,25339,25334.0,-20,LOSS,276,1759992565,1759992841
BUY,25333.75,25328.75,-20,LOSS,120,1759992841,1759992961
BUY,25328.5,25333.5,20,WIN,51,1759992961,1759993012
BUY,25333.75,25338.75,20,WIN,189,1759993012,1759993201
BUY,25339,25334.0,-20,LOSS,5,1759993201,1759993206
BUY,25334,25339.0,20,WIN,43,1759993206,1759993249
BUY,25338,25343.0,20,WIN,74,1759993249,1759993323
BUY,25343,25338.0,-20,LOSS,23,1759993323,1759993346
BUY,25338.75,25343.75,20,WIN,35,1759993346,1759993381
BUY,25344.25,25339.25,-20,LOSS,188,1759993381,1759993569
BUY,25339,25344.0,20,WIN,28,1759993569,1759993597
BUY,25344.5,25339.5,-20,LOSS,63,1759993597,1759993660
BUY,25339.25,25344.25,20,WIN,47,1759993660,1759993707
BUY,25344.5,25339.5,-20,LOSS,555,1759993707,1759994262
BUY,25339.5,25344.5,20,WIN,35,1759994262,1759994297
BUY,25345.75,25340.75,-20,LOSS,328,1759994297,1759994625
BUY,25341,25346.0,20,WIN,125,1759994625,1759994750
BUY,25346,25341.0,-20,LOSS,62,1759994750,1759994812
BUY,25340.75,25335.75,-20,LOSS,15,1759994812,1759994827
BUY,25335.5,25330.5,-20,LOSS,251,1759994827,1759995078
BUY,25330.25,25335.25,20,WIN,52,1759995078,1759995130
BUY,25335.25,25330.25,-20,LOSS,14,1759995130,1759995144
BUY,25330.25,25325.25,-20,LOSS,48,1759995144,1759995192
BUY,25325.5,25330.5,20,WIN,54,1759995192,1759995246
BUY,25330.25,25325.25,-20,LOSS,49,1759995246,1759995295
BUY,25325,25330.0,20,WIN,39,1759995295,1759995334
BUY,25330,25335.0,20,WIN,372,1759995334,1759995706
BUY,25335.25,25330.25,-20,LOSS,82,1759995706,1759995788
BUY,25330.5,25335.5,20,WIN,45,1759995788,1759995833
BUY,25336,25341.0,20,WIN,111,1759995833,1759995944
BUY,25341,25336.0,-20,LOSS,207,1759995944,1759996151
BUY,25336,25341.0,20,WIN,240,1759996151,1759996391
BUY,25341,25336.0,-20,LOSS,242,1759996391,1759996633
BUY,25336,25341.0,20,WIN,294,1759996633,1759996927
BUY,25341.25,25336.25,-20,LOSS,54,1759996927,1759996981
BUY,25336.5,25341.5,20,WIN,74,1759996981,1759997055
BUY,25341.75,25336.75,-20,LOSS,213,1759997055,1759997268
BUY,25336.75,25341.75,20,WIN,68,1759997268,1759997336
BUY,25341.75,25336.75,-20,LOSS,98,1759997336,1759997434
BUY,25335.75,25330.75,-20,LOSS,111,1759997434,1759997545
BUY,25330.75,25325.75,-20,LOSS,95,1759997545,1759997640
BUY,25325.25,25320.25,-20,LOSS,32,1759997640,1759997672
BUY,25320.5,25315.5,-20,LOSS,61,1759997672,1759997733
BUY,25316,25321.0,20,WIN,124,1759997733,1759997857
BUY,25320,25315.0,-20,LOSS,29,1759997857,1759997886
BUY,25315,25320.0,20,WIN,23,1759997886,1759997909
BUY,25319.75,25324.75,20,WIN,56,1759997909,1759997965
BUY,25325.5,25330.5,20,WIN,51,1759997965,1759998016
BUY,25330.5,25325.5,-20,LOSS,220,1759998016,1759998236
BUY,25325.5,25320.5,-20,LOSS,199,1759998236,1759998435
BUY,25320.5,25325.5,20,WIN,54,1759998435,1759998489
BUY,25325.5,25320.5,-20,LOSS,251,1759998489,1759998740
BUY,25320.25,25315.25,-20,LOSS,105,1759998740,1759998845
BUY,25315.5,25310.5,-20,LOSS,179,1759998845,1759999024
BUY,25311,25316.0,20,WIN,77,1759999024,1759999101
BUY,25315.25,25310.25,-20,LOSS,130,1759999101,1759999231
BUY,25309.5,25304.5,-20,LOSS,58,1759999231,1759999289
BUY,25303.5,25298.5,-20,LOSS,128,1759999289,1759999417
BUY,25300.5,25305.5,20,WIN,89,1759999417,1759999506
BUY,25304.75,25299.75,-20,LOSS,105,1759999506,1759999611
BUY,25299.75,25304.75,20,WIN,19,1759999611,1759999630
BUY,25304.75,25309.75,20,WIN,19,1759999630,1759999649
BUY,25310.25,25305.25,-20,LOSS,140,1759999649,1759999789
BUY,25305.5,25300.5,-20,LOSS,15,1759999789,1759999804
BUY,25300.25,25305.25,20,WIN,122,1759999804,1759999926
BUY,25304,25299.0,-20,LOSS,128,1759999926,1760000054
BUY,25298.5,25303.5,20,WIN,93,1760000054,1760000147
BUY,25304.25,25299.25,-20,LOSS,145,1760000147,1760000292
BUY,25298.75,25303.75,20,WIN,487,1760000292,1760000779
BUY,25303.5,25308.5,20,WIN,30,1760000779,1760000809
BUY,25308.25,25313.25,20,WIN,98,1760000809,1760000907
BUY,25311.75,25316.75,20,WIN,215,1760000907,1760001122
BUY,25316.5,25321.5,20,WIN,56,1760001122,1760001178
BUY,25320.75,25325.75,20,WIN,107,1760001178,1760001285
BUY,25320.25,25325.25,20,WIN,21,1760001335,1760001356
BUY,25322.5,25317.5,-20,LOSS,101,1760001363,1760001464
BUY,25318.25,25323.25,20,WIN,910,1760001464,1760002374
BUY,25323.25,25328.25,20,WIN,67,1760002374,1760002441
BUY,25336,25331.0,-20,LOSS,55,1760002566,1760002621
BUY,25330.75,25325.75,-20,LOSS,546,1760002621,1760003167
BUY,25326,25321.0,-20,LOSS,819,1760003167,1760003986
BUY,25321.5,25316.5,-20,LOSS,106,1760003986,1760004092
BUY,25316.75,25311.75,-20,LOSS,21,1760004092,1760004113
BUY,25311.75,25316.75,20,WIN,25,1760004113,1760004138
BUY,25316.5,25321.5,20,WIN,31,1760004138,1760004169
BUY,25321.75,25326.75,20,WIN,79,1760004169,1760004248
BUY,25326.5,25321.5,-20,LOSS,260,1760004248,1760004508
BUY,25321.5,25326.5,20,WIN,21,1760004508,1760004529
BUY,25326.75,25321.75,-20,LOSS,172,1760004529,1760004701
BUY,25321.75,25326.75,20,WIN,49,1760004701,1760004750
BUY,25326.5,25331.5,20,WIN,90,1760004750,1760004840
BUY,25331.5,25326.5,-20,LOSS,254,1760004840,1760005094
BUY,25326.5,25321.5,-20,LOSS,408,1760005094,1760005502
BUY,25321.5,25316.5,-20,LOSS,88,1760005502,1760005590
BUY,25316.25,25311.25,-20,LOSS,191,1760005590,1760005781
BUY,25311.75,25306.75,-20,LOSS,42,1760005781,1760005823
BUY,25306.75,25311.75,20,WIN,41,1760005823,1760005864
BUY,25312.25,25307.25,-20,LOSS,142,1760005864,1760006006
BUY,25307,25312.0,20,WIN,198,1760006006,1760006204
BUY,25312,25307.0,-20,LOSS,714,1760006204,1760006918
BUY,25307.75,25312.75,20,WIN,258,1760006918,1760007176
BUY,25311.5,25316.5,20,WIN,106,1760007176,1760007282
BUY,25316.5,25321.5,20,WIN,195,1760007282,1760007477
BUY,25320.75,25325.75,20,WIN,202,1760007477,1760007679
BUY,25326.25,25321.25,-20,LOSS,341,1760007679,1760008020
BUY,25321.75,25326.75,20,WIN,114,1760008020,1760008134
BUY,25327,25322.0,-20,LOSS,350,1760008134,1760008484
BUY,25321.75,25326.75,20,WIN,555,1760008484,1760009039
BUY,25327.25,25332.25,20,WIN,144,1760009039,1760009183
BUY,25328.25,25333.25,20,WIN,91,1760009233,1760009324
BUY,25334,25339.0,20,WIN,40,1760009403,1760009443
BUY,25337.5,25332.5,-20,LOSS,184,1760009496,1760009680
BUY,25332,25327.0,-20,LOSS,33,1760009680,1760009713
BUY,25327.5,25332.5,20,WIN,192,1760009713,1760009905
BUY,25332.75,25327.75,-20,LOSS,270,1760009905,1760010175
BUY,25327.75,25322.75,-20,LOSS,52,1760010175,1760010227
BUY,25323.75,25318.75,-20,LOSS,179,1760010227,1760010406
BUY,25318,25323.0,20,WIN,46,1760010406,1760010452
BUY,25322.25,25327.25,20,WIN,97,1760010452,1760010549
BUY,25327.5,25322.5,-20,LOSS,133,1760010549,1760010682
BUY,25323.25,25318.25,-20,LOSS,424,1760010682,1760011106
BUY,25318.25,25313.25,-20,LOSS,86,1760011106,1760011192
BUY,25312.5,25317.5,20,WIN,14,1760011192,1760011206
BUY,25318.5,25323.5,20,WIN,34,1760011206,1760011240
BUY,25323,25318.0,-20,LOSS,44,1760011240,1760011284
BUY,25318.25,25323.25,20,WIN,11,1760011284,1760011295
BUY,25322.75,25317.75,-20,LOSS,165,1760011295,1760011460
BUY,25317.75,25322.75,20,WIN,16,1760011460,1760011476
BUY,25323.25,25318.25,-20,LOSS,52,1760011476,1760011528
BUY,25318,25323.0,20,WIN,86,1760011528,1760011614
BUY,25322.75,25317.75,-20,LOSS,69,1760011614,1760011683
BUY,25317,25312.0,-20,LOSS,360,1760011683,1760012043
BUY,25312.25,25317.25,20,WIN,121,1760012043,1760012164
BUY,25317.5,25322.5,20,WIN,482,1760012164,1760012646
BUY,25322.75,25317.75,-20,LOSS,255,1760012646,1760012901
BUY,25318.25,25323.25,20,WIN,26,1760012901,1760012927
BUY,25323.25,25328.25,20,WIN,75,1760012927,1760013002
BUY,25329,25324.0,-20,LOSS,23,1760013002,1760013025
BUY,25324,25319.0,-20,LOSS,9,1760013025,1760013034
BUY,25318.75,25323.75,20,WIN,21,1760013034,1760013055
BUY,25324.25,25319.25,-20,LOSS,85,1760013055,1760013140
BUY,25318.75,25323.75,20,WIN,28,1760013140,1760013168
BUY,25324,25319.0,-20,LOSS,137,1760013168,1760013305
BUY,25318.75,25323.75,20,WIN,30,1760013305,1760013335
BUY,25323,25328.0,20,WIN,103,1760013335,1760013438
BUY,25328,25323.0,-20,LOSS,239,1760013438,1760013677
BUY,25323.5,25318.5,-20,LOSS,52,1760013677,1760013729
BUY,25319,25324.0,20,WIN,64,1760013729,1760013793
BUY,25324.5,25329.5,20,WIN,50,1760013793,1760013843
BUY,25324.5,25319.5,-20,LOSS,209,1760013932,1760014141
BUY,25320,25325.0,20,WIN,125,1760014141,1760014266
BUY,25324.5,25329.5,20,WIN,70,1760014266,1760014336
BUY,25328.25,25333.25,20,WIN,264,1760014400,1760014664
BUY,25331.25,25326.25,-20,LOSS,149,1760014738,1760014887
BUY,25327,25322.0,-20,LOSS,333,1760014887,1760015220
BUY,25320.75,25325.75,20,WIN,52,1760015220,1760015272
BUY,25326,25321.0,-20,LOSS,88,1760015272,1760015360
BUY,25321.75,25316.75,-20,LOSS,116,1760015360,1760015476
BUY,25317,25322.0,20,WIN,348,1760015476,1760015824
BUY,25322,25327.0,20,WIN,57,1760015824,1760015881
BUY,25327,25332.0,20,WIN,418,1760015881,1760016299
BUY,25330,25325.0,-20,LOSS,53,1760016304,1760016357
BUY,25326.25,25321.25,-20,LOSS,63,1760016357,1760016420
BUY,25321.25,25326.25,20,WIN,50,1760016420,1760016470
BUY,25323.75,25328.75,20,WIN,9,1760016470,1760016479
BUY,25326.75,25321.75,-20,LOSS,1,1760016479,1760016480
BUY,25323.75,25328.75,20,WIN,6,1760016480,1760016486
BUY,25329,25324.0,-20,LOSS,21,1760016486,1760016507
BUY,25324.75,25329.75,20,WIN,30,1760016507,1760016537
BUY,25329,25324.0,-20,LOSS,3,1760016599,1760016602
BUY,25320,25325.0,20,WIN,3,1760016602,1760016605
BUY,25322.5,25317.5,-20,LOSS,5,1760016605,1760016610
BUY,25311.5,25306.5,-20,LOSS,1,1760016610,1760016611
BUY,25310.5,25315.5,20,WIN,3,1760016611,1760016614
BUY,25315,25310.0,-20,LOSS,7,1760016614,1760016621
BUY,25311.75,25316.75,20,WIN,7,1760016621,1760016628
BUY,25318.25,25313.25,-20,LOSS,8,1760016628,1760016636
BUY,25311.75,25316.75,20,WIN,3,1760016636,1760016639
BUY,25318.5,25313.5,-20,LOSS,5,1760016639,1760016644
BUY,25312.75,25317.75,20,WIN,14,1760016644,1760016658
BUY,25319,25324.0,20,WIN,2,1760016658,1760016660
BUY,25323.75,25328.75,20,WIN,3,1760016660,1760016663
BUY,25328,25333.0,20,WIN,2,1760016663,1760016665
BUY,25329,25324.0,-20,LOSS,7,1760016670,1760016677
BUY,25328,25323.0,-20,LOSS,2,1760016677,1760016679
BUY,25325.5,25330.5,20,WIN,5,1760016679,1760016684
BUY,25326.75,25321.75,-20,LOSS,15,1760016690,1760016705
BUY,25321.5,25326.5,20,WIN,3,1760016705,1760016708
BUY,25326.75,25321.75,-20,LOSS,12,1760016708,1760016720
BUY,25319.75,25324.75,20,WIN,3,1760016720,1760016723
BUY,25321,25316.0,-20,LOSS,6,1760016723,1760016729
BUY,25316.25,25321.25,20,WIN,8,1760016729,1760016737
BUY,25320.75,25315.75,-20,LOSS,2,1760016737,1760016739
BUY,25316.25,25321.25,20,WIN,3,1760016739,1760016742
BUY,25320.25,25315.25,-20,LOSS,7,1760016742,1760016749
BUY,25314.5,25319.5,20,WIN,3,1760016749,1760016752
BUY,25318.25,25313.25,-20,LOSS,21,1760016752,1760016773
BUY,25313.25,25308.25,-20,LOSS,17,1760016773,1760016790
BUY,25307.25,25302.25,-20,LOSS,13,1760016790,1760016803
BUY,25302.5,25307.5,20,WIN,13,1760016803,1760016816
BUY,25306.25,25301.25,-20,LOSS,2,1760016816,1760016818
BUY,25302.5,25297.5,-20,LOSS,12,1760016818,1760016830
BUY,25297.25,25302.25,20,WIN,4,1760016830,1760016834
BUY,25302.5,25307.5,20,WIN,25,1760016834,1760016859
BUY,25308.5,25303.5,-20,LOSS,33,1760016859,1760016892
BUY,25303.5,25298.5,-20,LOSS,25,1760016892,1760016917
BUY,25299.25,25294.25,-20,LOSS,8,1760016917,1760016925
BUY,25293.25,25298.25,20,WIN,5,1760016925,1760016930
BUY,25299,25304.0,20,WIN,20,1760016930,1760016950
BUY,25306,25311.0,20,WIN,19,1760016950,1760016969
BUY,25311.25,25306.25,-20,LOSS,2,1760016969,1760016971
BUY,25307.75,25312.75,20,WIN,18,1760016971,1760016989
BUY,25312.5,25307.5,-20,LOSS,3,1760016989,1760016992
BUY,25308.75,25313.75,20,WIN,13,1760016992,1760017005
BUY,25313.75,25308.75,-20,LOSS,35,1760017005,1760017040
BUY,25306,25301.0,-20,LOSS,7,1760017040,1760017047
BUY,25300.25,25295.25,-20,LOSS,7,1760017047,1760017054
BUY,25295.75,25300.75,20,WIN,2,1760017054,1760017056
BUY,25300.5,25305.5,20,WIN,12,1760017056,1760017068
BUY,25305.5,25300.5,-20,LOSS,14,1760017068,1760017082
BUY,25300,25295.0,-20,LOSS,39,1760017082,1760017121
BUY,25294.75,25299.75,20,WIN,21,1760017121,1760017142
BUY,25299.75,25294.75,-20,LOSS,9,1760017142,1760017151
BUY,25294.75,25299.75,20,WIN,23,1760017151,1760017174
BUY,25302,25297.0,-20,LOSS,26,1760017174,1760017200
BUY,25297,25302.0,20,WIN,9,1760017200,1760017209
BUY,25301,25296.0,-20,LOSS,8,1760017209,1760017217
BUY,25295.5,25290.5,-20,LOSS,31,1760017217,1760017248
BUY,25288.75,25283.75,-20,LOSS,3,1760017248,1760017251
BUY,25287.5,25292.5,20,WIN,9,1760017251,1760017260
BUY,25290.75,25285.75,-20,LOSS,8,1760017260,1760017268
BUY,25286.5,25281.5,-20,LOSS,16,1760017268,1760017284
BUY,25282,25277.0,-20,LOSS,25,1760017284,1760017309
BUY,25277.75,25272.75,-20,LOSS,9,1760017309,1760017318
BUY,25273,25268.0,-20,LOSS,3,1760017318,1760017321
BUY,25269.5,25264.5,-20,LOSS,8,1760017321,1760017329
BUY,25264.5,25259.5,-20,LOSS,29,1760017329,1760017358
BUY,25261.25,25266.25,20,WIN,11,1760017358,1760017369
BUY,25267,25272.0,20,WIN,15,1760017369,1760017384
BUY,25272.25,25267.25,-20,LOSS,26,1760017384,1760017410
BUY,25268,25273.0,20,WIN,8,1760017410,1760017418
BUY,25273,25268.0,-20,LOSS,15,1760017418,1760017433
BUY,25269.75,25274.75,20,WIN,5,1760017433,1760017438
BUY,25275,25280.0,20,WIN,15,1760017438,1760017453
BUY,25281.25,25276.25,-20,LOSS,7,1760017453,1760017460
BUY,25275.25,25270.25,-20,LOSS,5,1760017460,1760017465
BUY,25271,25276.0,20,WIN,24,1760017465,1760017489
BUY,25274.75,25269.75,-20,LOSS,12,1760017489,1760017501
BUY,25269.5,25264.5,-20,LOSS,30,1760017501,1760017531
BUY,25261.75,25256.75,-20,LOSS,2,1760017531,1760017533
BUY,25256.75,25261.75,20,WIN,21,1760017533,1760017554
BUY,25261.75,25266.75,20,WIN,6,1760017554,1760017560
BUY,25266.5,25261.5,-20,LOSS,15,1760017560,1760017575
BUY,25262.5,25257.5,-20,LOSS,5,1760017575,1760017580
BUY,25256,25261.0,20,WIN,10,1760017580,1760017590
BUY,25260,25265.0,20,WIN,8,1760017590,1760017598
BUY,25263.25,25258.25,-20,LOSS,12,1760017598,1760017610
BUY,25256.75,25261.75,20,WIN,9,1760017610,1760017619
BUY,25264,25269.0,20,WIN,2,1760017619,1760017621
BUY,25267.75,25262.75,-20,LOSS,11,1760017621,1760017632
BUY,25262.75,25267.75,20,WIN,14,1760017632,1760017646
BUY,25267.25,25272.25,20,WIN,18,1760017646,1760017664
BUY,25272,25277.0,20,WIN,18,1760017664,1760017682
BUY,25277,25282.0,20,WIN,50,1760017682,1760017732
BUY,25298.75,25303.75,20,WIN,6,1760017813,1760017819
BUY,25299.25,25304.25,20,WIN,6,1760017840,1760017846
BUY,25299.5,25304.5,20,WIN,8,1760017850,1760017858
BUY,25306,25301.0,-20,LOSS,3,1760017903,1760017906
BUY,25301.25,25296.25,-20,LOSS,2,1760017906,1760017908
BUY,25297.25,25292.25,-20,LOSS,10,1760017908,1760017918
BUY,25284.25,25279.25,-20,LOSS,1,1760017918,1760017919
BUY,25283.25,25278.25,-20,LOSS,2,1760017919,1760017921
BUY,25276.75,25271.75,-20,LOSS,1,1760017921,1760017922
BUY,25277.25,25282.25,20,WIN,4,1760017922,1760017926
BUY,25279,25274.0,-20,LOSS,6,1760017926,1760017932
BUY,25276,25281.0,20,WIN,14,1760017932,1760017946
BUY,25282.5,25277.5,-20,LOSS,14,1760017946,1760017960
BUY,25278.5,25283.5,20,WIN,27,1760017960,1760017987
BUY,25285.25,25280.25,-20,LOSS,9,1760017987,1760017996
BUY,25281.5,25276.5,-20,LOSS,5,1760017996,1760018001
BUY,25274.5,25269.5,-20,LOSS,7,1760018001,1760018008
BUY,25269,25274.0,20,WIN,21,1760018008,1760018029
BUY,25274.75,25269.75,-20,LOSS,18,1760018029,1760018047
BUY,25269.5,25264.5,-20,LOSS,12,1760018047,1760018059
BUY,25264.75,25269.75,20,WIN,8,1760018059,1760018067
BUY,25267,25262.0,-20,LOSS,10,1760018067,1760018077
BUY,25264,25269.0,20,WIN,21,1760018077,1760018098
BUY,25266.75,25271.75,20,WIN,7,1760018098,1760018105
BUY,25271.25,25266.25,-20,LOSS,32,1760018105,1760018137
BUY,25266.25,25261.25,-20,LOSS,4,1760018137,1760018141
BUY,25260.75,25255.75,-20,LOSS,10,1760018141,1760018151
BUY,25254,25259.0,20,WIN,3,1760018151,1760018154
BUY,25258.25,25263.25,20,WIN,12,1760018154,1760018166
BUY,25263.5,25268.5,20,WIN,10,1760018166,1760018176
BUY,25266.25,25271.25,20,WIN,31,1760018176,1760018207
BUY,25271,25276.0,20,WIN,14,1760018207,1760018221
BUY,25277,25282.0,20,WIN,3,1760018221,1760018224
BUY,25286.25,25281.25,-20,LOSS,17,1760018224,1760018241
BUY,25281.5,25286.5,20,WIN,16,1760018241,1760018257
BUY,25286,25291.0,20,WIN,8,1760018257,1760018265
BUY,25290,25285.0,-20,LOSS,20,1760018265,1760018285
BUY,25286.5,25291.5,20,WIN,27,1760018285,1760018312
BUY,25287.25,25282.25,-20,LOSS,22,1760018317,1760018339
BUY,25282,25287.0,20,WIN,11,1760018339,1760018350
BUY,25286.5,25281.5,-20,LOSS,30,1760018350,1760018380
BUY,25281.5,25276.5,-20,LOSS,7,1760018380,1760018387
BUY,25276.25,25281.25,20,WIN,11,1760018387,1760018398
BUY,25281,25276.0,-20,LOSS,3,1760018398,1760018401
BUY,25274.25,25269.25,-20,LOSS,7,1760018401,1760018408
BUY,25272.5,25267.5,-20,LOSS,2,1760018408,1760018410
BUY,25265,25270.0,20,WIN,2,1760018410,1760018412
BUY,25268.75,25273.75,20,WIN,3,1760018412,1760018415
BUY,25272,25277.0,20,WIN,47,1760018415,1760018462
BUY,25277,25272.0,-20,LOSS,16,1760018462,1760018478
BUY,25272,25267.0,-20,LOSS,26,1760018478,1760018504
BUY,25266.5,25271.5,20,WIN,10,1760018504,1760018514
BUY,25271.75,25266.75,-20,LOSS,7,1760018514,1760018521
BUY,25267.25,25262.25,-20,LOSS,16,1760018521,1760018537
BUY,25264.75,25269.75,20,WIN,23,1760018537,1760018560
BUY,25270.25,25265.25,-20,LOSS,14,1760018560,1760018574
BUY,25265.75,25270.75,20,WIN,32,1760018574,1760018606
BUY,25270.25,25275.25,20,WIN,5,1760018606,1760018611
BUY,25274.75,25279.75,20,WIN,45,1760018611,1760018656
BUY,25276.75,25281.75,20,WIN,8,1760018694,1760018702
BUY,25281,25276.0,-20,LOSS,14,1760018728,1760018742
BUY,25276,25281.0,20,WIN,7,1760018742,1760018749
BUY,25279.25,25284.25,20,WIN,21,1760018757,1760018778
BUY,25280.75,25285.75,20,WIN,57,1760018789,1760018846
BUY,25280.5,25275.5,-20,LOSS,21,1760018872,1760018893
BUY,25276,25271.0,-20,LOSS,14,1760018893,1760018907
BUY,25268.25,25273.25,20,WIN,36,1760018907,1760018943
BUY,25271.75,25266.75,-20,LOSS,10,1760018943,1760018953
BUY,25265.75,25270.75,20,WIN,41,1760018953,1760018994
BUY,25271.75,25276.75,20,WIN,7,1760018994,1760019001
BUY,25275.75,25270.75,-20,LOSS,34,1760019001,1760019035
BUY,25270.75,25275.75,20,WIN,57,1760019035,1760019092
BUY,25275,25270.0,-20,LOSS,8,1760019092,1760019100
BUY,25270,25275.0,20,WIN,27,1760019100,1760019127
BUY,25274.25,25269.25,-20,LOSS,5,1760019127,1760019132
BUY,25270.25,25275.25,20,WIN,16,1760019132,1760019148
BUY,25276,25271.0,-20,LOSS,15,1760019148,1760019163
BUY,25270,25275.0,20,WIN,40,1760019163,1760019203
BUY,25275.75,25270.75,-20,LOSS,11,1760019203,1760019214
BUY,25270.25,25275.25,20,WIN,8,1760019214,1760019222
BUY,25275,25270.0,-20,LOSS,24,1760019222,1760019246
BUY,25270,25275.0,20,WIN,28,1760019246,1760019274
BUY,25274.5,25269.5,-20,LOSS,34,1760019274,1760019308
BUY,25269.75,25264.75,-20,LOSS,36,1760019308,1760019344
BUY,25265.5,25260.5,-20,LOSS,5,1760019344,1760019349
BUY,25260.25,25265.25,20,WIN,19,1760019349,1760019368
BUY,25265.75,25270.75,20,WIN,5,1760019368,1760019373
BUY,25270.5,25265.5,-20,LOSS,43,1760019373,1760019416
BUY,25266.25,25261.25,-20,LOSS,5,1760019416,1760019421
BUY,25259,25264.0,20,WIN,28,1760019421,1760019449
BUY,25264.25,25269.25,20,WIN,78,1760019449,1760019527
BUY,25270,25275.0,20,WIN,25,1760019527,1760019552
BUY,25274.5,25269.5,-20,LOSS,21,1760019552,1760019573
BUY,25269.75,25264.75,-20,LOSS,19,1760019573,1760019592
BUY,25264.75,25269.75,20,WIN,31,1760019592,1760019623
BUY,25269.75,25264.75,-20,LOSS,15,1760019623,1760019638
BUY,25263.5,25258.5,-20,LOSS,33,1760019638,1760019671
BUY,25258.75,25253.75,-20,LOSS,6,1760019671,1760019677
BUY,25253.25,25248.25,-20,LOSS,2,1760019677,1760019679
BUY,25250.25,25245.25,-20,LOSS,3,1760019679,1760019682
BUY,25245.75,25250.75,20,WIN,2,1760019682,1760019684
BUY,25252.25,25247.25,-20,LOSS,7,1760019684,1760019691
BUY,25248,25253.0,20,WIN,5,1760019691,1760019696
BUY,25251.75,25256.75,20,WIN,3,1760019696,1760019699
BUY,25256.25,25261.25,20,WIN,45,1760019699,1760019744
BUY,25261.25,25256.25,-20,LOSS,12,1760019744,1760019756
BUY,25255.5,25260.5,20,WIN,17,1760019756,1760019773
BUY,25260.25,25265.25,20,WIN,14,1760019773,1760019787
BUY,25264.75,25269.75,20,WIN,32,1760019787,1760019819
BUY,25268.75,25273.75,20,WIN,2,1760019819,1760019821
BUY,25271.5,25266.5,-20,LOSS,17,1760019903,1760019920
BUY,25269.5,25264.5,-20,LOSS,15,1760019920,1760019935
BUY,25264.75,25259.75,-20,LOSS,39,1760019935,1760019974
BUY,25259.5,25254.5,-20,LOSS,47,1760019974,1760020021
BUY,25254.75,25259.75,20,WIN,10,1760020021,1760020031
BUY,25259.5,25254.5,-20,LOSS,5,1760020031,1760020036
BUY,25255,25250.0,-20,LOSS,47,1760020036,1760020083
BUY,25250,25255.0,20,WIN,13,1760020083,1760020096
BUY,25255.5,25260.5,20,WIN,18,1760020096,1760020114
BUY,25260.5,25255.5,-20,LOSS,9,1760020114,1760020123
BUY,25255.75,25260.75,20,WIN,19,1760020123,1760020142
BUY,25260.75,25255.75,-20,LOSS,5,1760020142,1760020147
BUY,25255.25,25250.25,-20,LOSS,13,1760020147,1760020160
BUY,25248.75,25253.75,20,WIN,11,1760020160,1760020171
BUY,25253.25,25248.25,-20,LOSS,30,1760020171,1760020201
BUY,25248.75,25243.75,-20,LOSS,10,1760020201,1760020211
BUY,25242.5,25247.5,20,WIN,23,1760020211,1760020234
BUY,25248.75,25243.75,-20,LOSS,9,1760020234,1760020243
BUY,25243.5,25238.5,-20,LOSS,13,1760020243,1760020256
BUY,25240.75,25245.75,20,WIN,7,1760020256,1760020263
BUY,25246.25,25241.25,-20,LOSS,6,1760020263,1760020269
BUY,25241,25236.0,-20,LOSS,7,1760020269,1760020276
BUY,25235.5,25230.5,-20,LOSS,5,1760020276,1760020281
BUY,25230,25235.0,20,WIN,24,1760020281,1760020305
BUY,25234,25229.0,-20,LOSS,10,1760020305,1760020315
BUY,25228.75,25233.75,20,WIN,24,1760020315,1760020339
BUY,25232,25227.0,-20,LOSS,13,1760020339,1760020352
BUY,25227.25,25232.25,20,WIN,10,1760020352,1760020362
BUY,25232.5,25237.5,20,WIN,18,1760020362,1760020380
BUY,25237.25,25242.25,20,WIN,21,1760020380,1760020401
BUY,25243.25,25238.25,-20,LOSS,46,1760020401,1760020447
BUY,25238.5,25233.5,-20,LOSS,27,1760020447,1760020474
BUY,25233.5,25228.5,-20,LOSS,23,1760020474,1760020497
BUY,25228.5,25223.5,-20,LOSS,12,1760020497,1760020509
BUY,25222.5,25217.5,-20,LOSS,8,1760020509,1760020517
BUY,25218.75,25223.75,20,WIN,21,1760020517,1760020538
BUY,25223.5,25228.5,20,WIN,24,1760020538,1760020562
BUY,25228.25,25223.25,-20,LOSS,6,1760020562,1760020568
BUY,25224,25219.0,-20,LOSS,7,1760020568,1760020575
BUY,25220.25,25225.25,20,WIN,54,1760020575,1760020629
BUY,25224.5,25229.5,20,WIN,4,1760020629,1760020633
BUY,25231.5,25226.5,-20,LOSS,19,1760020633,1760020652
BUY,25229,25224.0,-20,LOSS,20,1760020652,1760020672
BUY,25225.5,25220.5,-20,LOSS,23,1760020672,1760020695
BUY,25221,25216.0,-20,LOSS,68,1760020695,1760020763
BUY,25216,25211.0,-20,LOSS,8,1760020763,1760020771
BUY,25211.75,25216.75,20,WIN,12,1760020771,1760020783
BUY,25216,25221.0,20,WIN,44,1760020783,1760020827
BUY,25220.5,25225.5,20,WIN,9,1760020827,1760020836
BUY,25226,25231.0,20,WIN,25,1760020836,1760020861
BUY,25230.75,25225.75,-20,LOSS,14,1760020861,1760020875
BUY,25226,25221.0,-20,LOSS,3,1760020875,1760020878
BUY,25221,25216.0,-20,LOSS,22,1760020878,1760020900
BUY,25216.25,25211.25,-20,LOSS,12,1760020900,1760020912
BUY,25210.5,25215.5,20,WIN,6,1760020912,1760020918
BUY,25216,25211.0,-20,LOSS,16,1760020918,1760020934
BUY,25212.5,25207.5,-20,LOSS,12,1760020934,1760020946
BUY,25208.75,25213.75,20,WIN,105,1760020946,1760021051
BUY,25214,25209.0,-20,LOSS,18,1760021051,1760021069
BUY,25208.25,25203.25,-20,LOSS,12,1760021069,1760021081
BUY,25205.25,25200.25,-20,LOSS,20,1760021081,1760021101
BUY,25197.75,25202.75,20,WIN,53,1760021101,1760021154
BUY,25202.75,25207.75,20,WIN,14,1760021154,1760021168
BUY,25207.75,25212.75,20,WIN,19,1760021168,1760021187
BUY,25211.5,25216.5,20,WIN,5,1760021187,1760021192
BUY,25216.75,25211.75,-20,LOSS,35,1760021192,1760021227
BUY,25212.25,25217.25,20,WIN,8,1760021227,1760021235
BUY,25217.25,25212.25,-20,LOSS,18,1760021235,1760021253
BUY,25212,25207.0,-20,LOSS,21,1760021253,1760021274
BUY,25207.75,25212.75,20,WIN,19,1760021274,1760021293
BUY,25212,25217.0,20,WIN,53,1760021293,1760021346
BUY,25216.75,25221.75,20,WIN,6,1760021346,1760021352
BUY,25221.5,25226.5,20,WIN,5,1760021352,1760021357
BUY,25229.75,25234.75,20,WIN,17,1760021419,1760021436
BUY,25232.75,25237.75,20,WIN,17,1760021460,1760021477
BUY,25238.5,25233.5,-20,LOSS,48,1760021538,1760021586
BUY,25235,25240.0,20,WIN,19,1760021586,1760021605
BUY,25238.5,25243.5,20,WIN,7,1760021612,1760021619
BUY,25239,25244.0,20,WIN,78,1760021642,1760021720
BUY,25239.75,25244.75,20,WIN,36,1760021742,1760021778
BUY,25240.75,25245.75,20,WIN,29,1760021786,1760021815
BUY,25242.25,25247.25,20,WIN,30,1760021833,1760021863
BUY,25253.5,25248.5,-20,LOSS,47,1760021936,1760021983
BUY,25249,25254.0,20,WIN,18,1760021983,1760022001
BUY,25253.75,25258.75,20,WIN,7,1760022001,1760022008
BUY,25261.5,25256.5,-20,LOSS,79,1760022069,1760022148
BUY,25256.5,25251.5,-20,LOSS,12,1760022148,1760022160
BUY,25250,25245.0,-20,LOSS,3,1760022160,1760022163
BUY,25243.25,25248.25,20,WIN,14,1760022163,1760022177
BUY,25248.25,25253.25,20,WIN,24,1760022177,1760022201
BUY,25253.75,25248.75,-20,LOSS,9,1760022201,1760022210
BUY,25249,25254.0,20,WIN,24,1760022210,1760022234
BUY,25254.5,25259.5,20,WIN,10,1760022234,1760022244
BUY,25259.25,25254.25,-20,LOSS,25,1760022244,1760022269
BUY,25254.75,25259.75,20,WIN,32,1760022269,1760022301
BUY,25258.5,25263.5,20,WIN,45,1760022301,1760022346
BUY,25260.25,25255.25,-20,LOSS,48,1760022360,1760022408
BUY,25256.5,25251.5,-20,LOSS,42,1760022408,1760022450
BUY,25251,25246.0,-20,LOSS,15,1760022450,1760022465
BUY,25246.5,25251.5,20,WIN,35,1760022465,1760022500
BUY,25251,25256.0,20,WIN,19,1760022500,1760022519
BUY,25255.5,25260.5,20,WIN,55,1760022519,1760022574
BUY,25259.75,25264.75,20,WIN,10,1760022575,1760022585
BUY,25260.75,25255.75,-20,LOSS,21,1760022617,1760022638
BUY,25256,25251.0,-20,LOSS,73,1760022638,1760022711
BUY,25251.75,25256.75,20,WIN,18,1760022711,1760022729
BUY,25255.75,25260.75,20,WIN,177,1760022729,1760022906
BUY,25260.25,25265.25,20,WIN,18,1760022906,1760022924
BUY,25266.5,25261.5,-20,LOSS,87,1760022983,1760023070
BUY,25260,25255.0,-20,LOSS,44,1760023070,1760023114
BUY,25253.5,25258.5,20,WIN,5,1760023114,1760023119
BUY,25258.75,25263.75,20,WIN,51,1760023119,1760023170
BUY,25263.5,25258.5,-20,LOSS,14,1760023170,1760023184
BUY,25259.25,25254.25,-20,LOSS,39,1760023184,1760023223
BUY,25251.75,25256.75,20,WIN,37,1760023223,1760023260
BUY,25256.75,25251.75,-20,LOSS,9,1760023260,1760023269
BUY,25251,25246.0,-20,LOSS,37,1760023269,1760023306
BUY,25245,25250.0,20,WIN,40,1760023306,1760023346
BUY,25249.75,25244.75,-20,LOSS,68,1760023346,1760023414
BUY,25245,25240.0,-20,LOSS,5,1760023414,1760023419
BUY,25241.5,25236.5,-20,LOSS,7,1760023419,1760023426
BUY,25236.25,25231.25,-20,LOSS,34,1760023426,1760023460
BUY,25232.5,25237.5,20,WIN,57,1760023460,1760023517
BUY,25236.5,25231.5,-20,LOSS,14,1760023517,1760023531
BUY,25233.25,25238.25,20,WIN,4,1760023531,1760023535
BUY,25238.25,25233.25,-20,LOSS,85,1760023535,1760023620
BUY,25231.75,25226.75,-20,LOSS,5,1760023620,1760023625
BUY,25227.25,25232.25,20,WIN,12,1760023625,1760023637
BUY,25232.5,25227.5,-20,LOSS,15,1760023637,1760023652
BUY,25226.5,25231.5,20,WIN,26,1760023652,1760023678
BUY,25232.5,25227.5,-20,LOSS,33,1760023678,1760023711
BUY,25228.5,25223.5,-20,LOSS,48,1760023711,1760023759
BUY,25224.25,25229.25,20,WIN,17,1760023759,1760023776
BUY,25229.5,25224.5,-20,LOSS,40,1760023776,1760023816
BUY,25224.5,25229.5,20,WIN,39,1760023816,1760023855
BUY,25229.5,25224.5,-20,LOSS,28,1760023855,1760023883
BUY,25224,25219.0,-20,LOSS,30,1760023883,1760023913
BUY,25220.25,25225.25,20,WIN,12,1760023913,1760023925
BUY,25225.25,25220.25,-20,LOSS,90,1760023925,1760024015
BUY,25219.5,25214.5,-20,LOSS,60,1760024015,1760024075
BUY,25211.75,25206.75,-20,LOSS,4,1760024075,1760024079
BUY,25207.5,25202.5,-20,LOSS,32,1760024079,1760024111
BUY,25202,25207.0,20,WIN,24,1760024111,1760024135
BUY,25207.5,25212.5,20,WIN,36,1760024135,1760024171
BUY,25213.75,25218.75,20,WIN,48,1760024171,1760024219
BUY,25218.75,25223.75,20,WIN,14,1760024219,1760024233
BUY,25223.25,25228.25,20,WIN,71,1760024233,1760024304
BUY,25229.25,25234.25,20,WIN,4,1760024304,1760024308
BUY,25233.75,25228.75,-20,LOSS,26,1760024308,1760024334
BUY,25229.5,25224.5,-20,LOSS,20,1760024334,1760024354
BUY,25224.75,25229.75,20,WIN,17,1760024354,1760024371
BUY,25229,25224.0,-20,LOSS,19,1760024371,1760024390
BUY,25225,25220.0,-20,LOSS,22,1760024390,1760024412
BUY,25220.25,25215.25,-20,LOSS,12,1760024412,1760024424
BUY,25217,25222.0,20,WIN,18,1760024424,1760024442
BUY,25221.5,25216.5,-20,LOSS,16,1760024442,1760024458
BUY,25216.25,25211.25,-20,LOSS,15,1760024458,1760024473
BUY,25211.75,25216.75,20,WIN,27,1760024473,1760024500
BUY,25216,25211.0,-20,LOSS,56,1760024500,1760024556
BUY,25210,25215.0,20,WIN,13,1760024556,1760024569
BUY,25215,25220.0,20,WIN,102,1760024569,1760024671
BUY,25219.5,25214.5,-20,LOSS,21,1760024671,1760024692
BUY,25215.25,25220.25,20,WIN,15,1760024692,1760024707
BUY,25220.5,25215.5,-20,LOSS,68,1760024707,1760024775
BUY,25216,25221.0,20,WIN,13,1760024775,1760024788
BUY,25221.5,25226.5,20,WIN,23,1760024788,1760024811
BUY,25227,25222.0,-20,LOSS,57,1760024811,1760024868
BUY,25222.25,25227.25,20,WIN,3,1760024868,1760024871
BUY,25228,25233.0,20,WIN,45,1760024871,1760024916
BUY,25252.5,25257.5,20,WIN,25,1760025077,1760025102
BUY,25258.5,25263.5,20,WIN,55,1760025161,1760025216
BUY,25259.25,25264.25,20,WIN,42,1760025250,1760025292
BUY,25263.5,25268.5,20,WIN,25,1760025326,1760025351
BUY,25263.75,25268.75,20,WIN,89,1760025363,1760025452
BUY,25269.25,25264.25,-20,LOSS,79,1760025514,1760025593
BUY,25264.25,25269.25,20,WIN,15,1760025593,1760025608
BUY,25267.75,25272.75,20,WIN,24,1760025608,1760025632
BUY,25270,25265.0,-20,LOSS,62,1760025638,1760025700
BUY,25267,25262.0,-20,LOSS,50,1760025700,1760025750
BUY,25262.5,25267.5,20,WIN,75,1760025750,1760025825
BUY,25268,25263.0,-20,LOSS,213,1760025825,1760026038
BUY,25262.75,25257.75,-20,LOSS,14,1760026038,1760026052
BUY,25256,25261.0,20,WIN,29,1760026052,1760026081
BUY,25261.25,25266.25,20,WIN,51,1760026081,1760026132
BUY,25267.5,25262.5,-20,LOSS,77,1760026132,1760026209
BUY,25263,25268.0,20,WIN,164,1760026209,1760026373
BUY,25268.5,25273.5,20,WIN,18,1760026373,1760026391
BUY,25268.25,25263.25,-20,LOSS,21,1760026427,1760026448
BUY,25262.5,25267.5,20,WIN,186,1760026448,1760026634
BUY,25267,25272.0,20,WIN,104,1760026634,1760026738
BUY,25266.75,25261.75,-20,LOSS,15,1760026773,1760026788
BUY,25261.75,25256.75,-20,LOSS,25,1760026788,1760026813
BUY,25256.5,25251.5,-20,LOSS,10,1760026813,1760026823
BUY,25250.5,25245.5,-20,LOSS,60,1760026823,1760026883
BUY,25245.25,25250.25,20,WIN,24,1760026883,1760026907
BUY,25250.75,25245.75,-20,LOSS,20,1760026907,1760026927
BUY,25246.25,25241.25,-20,LOSS,10,1760026927,1760026937
BUY,25240,25235.0,-20,LOSS,47,1760026937,1760026984
BUY,25235,25240.0,20,WIN,4,1760026984,1760026988
BUY,25242,25247.0,20,WIN,29,1760026988,1760027017
BUY,25247.5,25252.5,20,WIN,44,1760027017,1760027061
BUY,25252.75,25257.75,20,WIN,44,1760027061,1760027105
BUY,25257,25262.0,20,WIN,20,1760027105,1760027125
BUY,25262.75,25257.75,-20,LOSS,7,1760027125,1760027132
BUY,25258.25,25253.25,-20,LOSS,26,1760027132,1760027158
BUY,25250,25255.0,20,WIN,3,1760027158,1760027161
BUY,25255.75,25250.75,-20,LOSS,6,1760027161,1760027167
BUY,25249.75,25254.75,20,WIN,18,1760027167,1760027185
BUY,25254.75,25249.75,-20,LOSS,18,1760027185,1760027203
BUY,25251.75,25256.75,20,WIN,59,1760027203,1760027262
BUY,25257,25262.0,20,WIN,18,1760027262,1760027280
BUY,25261.25,25256.25,-20,LOSS,19,1760027280,1760027299
BUY,25256.5,25251.5,-20,LOSS,32,1760027299,1760027331
BUY,25252,25257.0,20,WIN,107,1760027331,1760027438
BUY,25257.25,25252.25,-20,LOSS,11,1760027438,1760027449
BUY,25251.5,25256.5,20,WIN,37,1760027449,1760027486
BUY,25256,25251.0,-20,LOSS,35,1760027486,1760027521
BUY,25250.75,25255.75,20,WIN,61,1760027521,1760027582
BUY,25255.25,25250.25,-20,LOSS,5,1760027582,1760027587
BUY,25249.75,25254.75,20,WIN,32,1760027587,1760027619
BUY,25254.75,25259.75,20,WIN,34,1760027619,1760027653
BUY,25259.25,25254.25,-20,LOSS,80,1760027653,1760027733
BUY,25254.75,25259.75,20,WIN,61,1760027733,1760027794
BUY,25258.5,25253.5,-20,LOSS,77,1760027794,1760027871
BUY,25253.75,25248.75,-20,LOSS,61,1760027871,1760027932
BUY,25249.25,25254.25,20,WIN,30,1760027932,1760027962
BUY,25255,25250.0,-20,LOSS,38,1760027962,1760028000
BUY,25250.25,25245.25,-20,LOSS,21,1760028000,1760028021
BUY,25246.25,25241.25,-20,LOSS,10,1760028021,1760028031
BUY,25241.25,25236.25,-20,LOSS,11,1760028031,1760028042
BUY,25236.25,25231.25,-20,LOSS,30,1760028042,1760028072
BUY,25231.75,25226.75,-20,LOSS,2,1760028072,1760028074
BUY,25226.75,25231.75,20,WIN,5,1760028074,1760028079
BUY,25231.25,25226.25,-20,LOSS,8,1760028079,1760028087
BUY,25227.25,25222.25,-20,LOSS,11,1760028087,1760028098
BUY,25220.75,25225.75,20,WIN,51,1760028098,1760028149
BUY,25225.25,25230.25,20,WIN,26,1760028149,1760028175
BUY,25230.25,25235.25,20,WIN,34,1760028175,1760028209
BUY,25234.75,25239.75,20,WIN,14,1760028209,1760028223
BUY,25240.5,25245.5,20,WIN,93,1760028223,1760028316
BUY,25246.25,25251.25,20,WIN,8,1760028316,1760028324
BUY,25249.75,25254.75,20,WIN,11,1760028324,1760028335
BUY,25247,25242.0,-20,LOSS,19,1760028366,1760028385
BUY,25241.75,25246.75,20,WIN,45,1760028385,1760028430
BUY,25246.5,25251.5,20,WIN,10,1760028430,1760028440
BUY,25250,25245.0,-20,LOSS,21,1760028482,1760028503
BUY,25246.25,25251.25,20,WIN,18,1760028503,1760028521
BUY,25254.75,25249.75,-20,LOSS,9,1760028618,1760028627
BUY,25248.25,25253.25,20,WIN,4,1760028627,1760028631
BUY,25253.5,25248.5,-20,LOSS,58,1760028631,1760028689
BUY,25248.25,25253.25,20,WIN,10,1760028689,1760028699
BUY,25252.75,25247.75,-20,LOSS,26,1760028699,1760028725
BUY,25248.75,25243.75,-20,LOSS,21,1760028725,1760028746
BUY,25244,25239.0,-20,LOSS,58,1760028746,1760028804
BUY,25239,25244.0,20,WIN,23,1760028804,1760028827
BUY,25243.25,25238.25,-20,LOSS,37,1760028827,1760028864
BUY,25238.75,25233.75,-20,LOSS,29,1760028864,1760028893
BUY,25228.5,25223.5,-20,LOSS,13,1760028893,1760028906
BUY,25224.5,25229.5,20,WIN,59,1760028906,1760028965
BUY,25229.75,25224.75,-20,LOSS,10,1760028965,1760028975
BUY,25224.25,25219.25,-20,LOSS,64,1760028975,1760029039
BUY,25219,25214.0,-20,LOSS,27,1760029039,1760029066
BUY,25212.75,25207.75,-20,LOSS,19,1760029066,1760029085
BUY,25207.5,25202.5,-20,LOSS,4,1760029085,1760029089
BUY,25201.25,25206.25,20,WIN,28,1760029089,1760029117
BUY,25207.75,25202.75,-20,LOSS,6,1760029117,1760029123
BUY,25202.75,25197.75,-20,LOSS,12,1760029123,1760029135
BUY,25198,25203.0,20,WIN,10,1760029135,1760029145
BUY,25203.25,25208.25,20,WIN,23,1760029145,1760029168
BUY,25209.75,25204.75,-20,LOSS,25,1760029168,1760029193
BUY,25205.75,25200.75,-20,LOSS,6,1760029193,1760029199
BUY,25200.25,25205.25,20,WIN,4,1760029199,1760029203
BUY,25203.75,25208.75,20,WIN,8,1760029203,1760029211
BUY,25208.5,25213.5,20,WIN,6,1760029211,1760029217
BUY,25215.25,25210.25,-20,LOSS,7,1760029217,1760029224
BUY,25211.5,25206.5,-20,LOSS,11,1760029224,1760029235
BUY,25209.75,25214.75,20,WIN,10,1760029235,1760029245
BUY,25215.5,25210.5,-20,LOSS,23,1760029245,1760029268
BUY,25211.5,25216.5,20,WIN,52,1760029268,1760029320
BUY,25215.25,25210.25,-20,LOSS,11,1760029320,1760029331
BUY,25211.75,25216.75,20,WIN,5,1760029331,1760029336
BUY,25218,25213.0,-20,LOSS,8,1760029336,1760029344
BUY,25214,25209.0,-20,LOSS,14,1760029344,1760029358
BUY,25209,25204.0,-20,LOSS,16,1760029358,1760029374
BUY,25203.75,25198.75,-20,LOSS,8,1760029374,1760029382
BUY,25197.5,25202.5,20,WIN,5,1760029382,1760029387
BUY,25203.25,25208.25,20,WIN,15,1760029387,1760029402
BUY,25209.5,25204.5,-20,LOSS,21,1760029402,1760029423
BUY,25204.75,25199.75,-20,LOSS,7,1760029423,1760029430
BUY,25198.75,25203.75,20,WIN,15,1760029430,1760029445
BUY,25204.25,25209.25,20,WIN,42,1760029445,1760029487
BUY,25210.75,25205.75,-20,LOSS,36,1760029487,1760029523
BUY,25207.25,25202.25,-20,LOSS,6,1760029523,1760029529
BUY,25200.75,25195.75,-20,LOSS,5,1760029529,1760029534
BUY,25197.25,25202.25,20,WIN,21,1760029534,1760029555
BUY,25201.5,25206.5,20,WIN,13,1760029555,1760029568
BUY,25206.5,25211.5,20,WIN,10,1760029568,1760029578
BUY,25211.25,25206.25,-20,LOSS,24,1760029578,1760029602
BUY,25205.5,25210.5,20,WIN,6,1760029602,1760029608
BUY,25210.75,25215.75,20,WIN,13,1760029608,1760029621
BUY,25214.75,25209.75,-20,LOSS,8,1760029621,1760029629
BUY,25208,25213.0,20,WIN,18,1760029629,1760029647
BUY,25212.75,25217.75,20,WIN,28,1760029647,1760029675
BUY,25217,25212.0,-20,LOSS,34,1760029675,1760029709
BUY,25212.5,25217.5,20,WIN,19,1760029709,1760029728
BUY,25224.75,25219.75,-20,LOSS,22,1760029792,1760029814
BUY,25220,25215.0,-20,LOSS,5,1760029814,1760029819
BUY,25215.75,25210.75,-20,LOSS,4,1760029819,1760029823
BUY,25211.75,25216.75,20,WIN,16,1760029823,1760029839
BUY,25217,25212.0,-20,LOSS,19,1760029839,1760029858
BUY,25212.25,25207.25,-20,LOSS,5,1760029858,1760029863
BUY,25208,25213.0,20,WIN,120,1760029863,1760029983
BUY,25212.5,25207.5,-20,LOSS,16,1760029983,1760029999
BUY,25207.25,25202.25,-20,LOSS,25,1760029999,1760030024
BUY,25202,25197.0,-20,LOSS,17,1760030024,1760030041
BUY,25197,25192.0,-20,LOSS,11,1760030041,1760030052
BUY,25193.25,25198.25,20,WIN,5,1760030052,1760030057
BUY,25196.25,25201.25,20,WIN,27,1760030057,1760030084
BUY,25201.75,25206.75,20,WIN,22,1760030084,1760030106
BUY,25206.75,25201.75,-20,LOSS,10,1760030106,1760030116
BUY,25199.75,25194.75,-20,LOSS,17,1760030116,1760030133
BUY,25194.75,25199.75,20,WIN,50,1760030133,1760030183
BUY,25198,25193.0,-20,LOSS,28,1760030183,1760030211
BUY,25193.5,25188.5,-20,LOSS,8,1760030211,1760030219
BUY,25187.75,25192.75,20,WIN,3,1760030219,1760030222
BUY,25194.75,25189.75,-20,LOSS,25,1760030222,1760030247
BUY,25189.5,25184.5,-20,LOSS,27,1760030247,1760030274
BUY,25185.25,25180.25,-20,LOSS,2,1760030274,1760030276
BUY,25179,25184.0,20,WIN,31,1760030276,1760030307
BUY,25183.75,25188.75,20,WIN,8,1760030307,1760030315
BUY,25188.75,25193.75,20,WIN,14,1760030315,1760030329
BUY,25193.5,25188.5,-20,LOSS,17,1760030329,1760030346
BUY,25188,25193.0,20,WIN,19,1760030346,1760030365
BUY,25192.25,25197.25,20,WIN,47,1760030365,1760030412
BUY,25197,25202.0,20,WIN,6,1760030412,1760030418
BUY,25203,25208.0,20,WIN,13,1760030418,1760030431
BUY,25208.25,25213.25,20,WIN,29,1760030431,1760030460
BUY,25210.75,25205.75,-20,LOSS,15,1760030463,1760030478
BUY,25205.25,25200.25,-20,LOSS,16,1760030478,1760030494
BUY,25201.25,25196.25,-20,LOSS,8,1760030494,1760030502
BUY,25195.5,25200.5,20,WIN,64,1760030502,1760030566
BUY,25201.25,25196.25,-20,LOSS,24,1760030566,1760030590
BUY,25196.5,25201.5,20,WIN,12,1760030590,1760030602
BUY,25201.75,25196.75,-20,LOSS,33,1760030602,1760030635
BUY,25196.5,25191.5,-20,LOSS,44,1760030635,1760030679
BUY,25191.25,25196.25,20,WIN,24,1760030679,1760030703
BUY,25196.75,25191.75,-20,LOSS,17,1760030703,1760030720
BUY,25191.75,25186.75,-20,LOSS,59,1760030720,1760030779
BUY,25185.5,25180.5,-20,LOSS,4,1760030779,1760030783
BUY,25181,25186.0,20,WIN,32,1760030783,1760030815
BUY,25186,25181.0,-20,LOSS,42,1760030815,1760030857
BUY,25181,25176.0,-20,LOSS,7,1760030857,1760030864
BUY,25177,25182.0,20,WIN,19,1760030864,1760030883
BUY,25181.75,25176.75,-20,LOSS,24,1760030883,1760030907
BUY,25176.5,25181.5,20,WIN,33,1760030907,1760030940
BUY,25181.25,25176.25,-20,LOSS,14,1760030940,1760030954
BUY,25173.25,25178.25,20,WIN,18,1760030954,1760030972
BUY,25178.25,25173.25,-20,LOSS,30,1760030972,1760031002
BUY,25174.5,25169.5,-20,LOSS,18,1760031002,1760031020
BUY,25164.75,25169.75,20,WIN,11,1760031020,1760031031
BUY,25169,25174.0,20,WIN,15,1760031031,1760031046
BUY,25174.5,25169.5,-20,LOSS,7,1760031046,1760031053
BUY,25169.75,25174.75,20,WIN,8,1760031053,1760031061
BUY,25176.75,25181.75,20,WIN,7,1760031061,1760031068
BUY,25181.5,25186.5,20,WIN,15,1760031068,1760031083
BUY,25187.5,25182.5,-20,LOSS,13,1760031083,1760031096
BUY,25183.25,25178.25,-20,LOSS,53,1760031096,1760031149
BUY,25178.25,25173.25,-20,LOSS,82,1760031149,1760031231
BUY,25173.5,25178.5,20,WIN,21,1760031231,1760031252
BUY,25178.25,25173.25,-20,LOSS,53,1760031252,1760031305
BUY,25173,25168.0,-20,LOSS,8,1760031305,1760031313
BUY,25169,25164.0,-20,LOSS,3,1760031313,1760031316
BUY,25164.75,25169.75,20,WIN,62,1760031316,1760031378
BUY,25170.25,25175.25,20,WIN,20,1760031378,1760031398
BUY,25174,25179.0,20,WIN,12,1760031398,1760031410
BUY,25178.75,25183.75,20,WIN,25,1760031410,1760031435
BUY,25183.5,25188.5,20,WIN,15,1760031435,1760031450
BUY,25207.25,25202.25,-20,LOSS,42,1760031664,1760031706
BUY,25201.75,25196.75,-20,LOSS,32,1760031706,1760031738
BUY,25197,25192.0,-20,LOSS,49,1760031738,1760031787
BUY,25191.25,25196.25,20,WIN,12,1760031787,1760031799
BUY,25196.5,25191.5,-20,LOSS,29,1760031799,1760031828
BUY,25191.25,25196.25,20,WIN,54,1760031828,1760031882
BUY,25196.5,25201.5,20,WIN,29,1760031882,1760031911
BUY,25200.75,25195.75,-20,LOSS,15,1760031911,1760031926
BUY,25197.25,25192.25,-20,LOSS,68,1760031926,1760031994
BUY,25192,25197.0,20,WIN,4,1760031994,1760031998
BUY,25197,25202.0,20,WIN,22,1760031998,1760032020
BUY,25201.75,25196.75,-20,LOSS,19,1760032020,1760032039
BUY,25196.75,25201.75,20,WIN,19,1760032039,1760032058
BUY,25203,25208.0,20,WIN,88,1760032058,1760032146
BUY,25214.25,25209.25,-20,LOSS,10,1760032291,1760032301
BUY,25209,25204.0,-20,LOSS,7,1760032301,1760032308
BUY,25203.25,25198.25,-20,LOSS,24,1760032308,1760032332
BUY,25197.5,25202.5,20,WIN,14,1760032332,1760032346
BUY,25202,25207.0,20,WIN,105,1760032346,1760032451
BUY,25207,25202.0,-20,LOSS,72,1760032451,1760032523
BUY,25201.5,25206.5,20,WIN,72,1760032523,1760032595
BUY,25207.75,25212.75,20,WIN,155,1760032595,1760032750
BUY,25212.25,25217.25,20,WIN,40,1760032750,1760032790
BUY,25210.5,25205.5,-20,LOSS,2,1760032813,1760032815
BUY,25208,25213.0,20,WIN,3,1760032815,1760032818
BUY,25212.5,25217.5,20,WIN,22,1760032818,1760032840
BUY,25213.25,25208.25,-20,LOSS,24,1760032854,1760032878
BUY,25208.5,25203.5,-20,LOSS,11,1760032878,1760032889
BUY,25204.5,25209.5,20,WIN,81,1760032889,1760032970
BUY,25211.25,25206.25,-20,LOSS,11,1760032970,1760032981
BUY,25206.75,25201.75,-20,LOSS,52,1760032981,1760033033
BUY,25202,25197.0,-20,LOSS,26,1760033033,1760033059
BUY,25196.75,25191.75,-20,LOSS,136,1760033059,1760033195
BUY,25191.25,25186.25,-20,LOSS,9,1760033195,1760033204
BUY,25186.25,25191.25,20,WIN,43,1760033204,1760033247
BUY,25192.5,25187.5,-20,LOSS,11,1760033247,1760033258
BUY,25187,25192.0,20,WIN,20,1760033258,1760033278
BUY,25192,25197.0,20,WIN,63,1760033278,1760033341
BUY,25196.25,25201.25,20,WIN,61,1760033341,1760033402
BUY,25201.5,25206.5,20,WIN,109,1760033402,1760033511
BUY,25206,25211.0,20,WIN,19,1760033511,1760033530
BUY,25209.75,25204.75,-20,LOSS,8,1760033534,1760033542
BUY,25205.75,25210.75,20,WIN,23,1760033542,1760033565
BUY,25210,25205.0,-20,LOSS,66,1760033567,1760033633
BUY,25204.5,25209.5,20,WIN,46,1760033633,1760033679
BUY,25209,25204.0,-20,LOSS,56,1760033680,1760033736
BUY,25204.75,25209.75,20,WIN,4,1760033736,1760033740
BUY,25225.75,25220.75,-20,LOSS,38,1760033892,1760033930
BUY,25221.5,25216.5,-20,LOSS,150,1760033930,1760034080
BUY,25215.5,25220.5,20,WIN,26,1760034080,1760034106
BUY,25220.25,25225.25,20,WIN,45,1760034106,1760034151
BUY,25224.75,25219.75,-20,LOSS,54,1760034151,1760034205
BUY,25220,25225.0,20,WIN,41,1760034205,1760034246
BUY,25224.5,25229.5,20,WIN,93,1760034246,1760034339
BUY,25230.5,25225.5,-20,LOSS,29,1760034435,1760034464
BUY,25226,25221.0,-20,LOSS,30,1760034464,1760034494
BUY,25221.75,25216.75,-20,LOSS,34,1760034494,1760034528
BUY,25217.25,25212.25,-20,LOSS,71,1760034528,1760034599
BUY,25213.25,25218.25,20,WIN,86,1760034599,1760034685
BUY,25220.25,25215.25,-20,LOSS,24,1760034685,1760034709
BUY,25215.25,25210.25,-20,LOSS,75,1760034709,1760034784
BUY,25210.25,25205.25,-20,LOSS,3,1760034784,1760034787
BUY,25209,25214.0,20,WIN,11,1760034787,1760034798
BUY,25214.25,25209.25,-20,LOSS,11,1760034798,1760034809
BUY,25209.25,25214.25,20,WIN,91,1760034809,1760034900
BUY,25215,25210.0,-20,LOSS,16,1760034900,1760034916
BUY,25209.75,25214.75,20,WIN,51,1760034916,1760034967
BUY,25215.5,25210.5,-20,LOSS,11,1760034967,1760034978
BUY,25210.5,25215.5,20,WIN,60,1760034978,1760035038
BUY,25215.75,25220.75,20,WIN,205,1760035038,1760035243
BUY,25221,25216.0,-20,LOSS,57,1760035243,1760035300
BUY,25216.25,25221.25,20,WIN,170,1760035300,1760035470
BUY,25221.25,25216.25,-20,LOSS,65,1760035470,1760035535
BUY,25215.75,25220.75,20,WIN,104,1760035535,1760035639
BUY,25220.75,25225.75,20,WIN,18,1760035639,1760035657
BUY,25225.25,25220.25,-20,LOSS,120,1760035657,1760035777
BUY,25220.75,25215.75,-20,LOSS,51,1760035777,1760035828
BUY,25215.75,25220.75,20,WIN,4,1760035828,1760035832
BUY,25221,25226.0,20,WIN,22,1760035832,1760035854
BUY,25220.75,25215.75,-20,LOSS,30,1760035894,1760035924
BUY,25215.75,25220.75,20,WIN,134,1760035924,1760036058
BUY,25220.5,25225.5,20,WIN,82,1760036058,1760036140
BUY,25237.75,25242.75,20,WIN,282,1760036251,1760036533
BUY,25237.75,25242.75,20,WIN,58,1760036557,1760036615
BUY,25243,25248.0,20,WIN,132,1760036674,1760036806
BUY,25243.5,25248.5,20,WIN,98,1760036844,1760036942
BUY,25248.5,25253.5,20,WIN,69,1760037050,1760037119
BUY,25254.5,25249.5,-20,LOSS,6,1760037179,1760037185
BUY,25249.25,25244.25,-20,LOSS,140,1760037185,1760037325
BUY,25240.75,25245.75,20,WIN,2,1760037325,1760037327
BUY,25245,25250.0,20,WIN,10,1760037327,1760037337
BUY,25248,25243.0,-20,LOSS,4,1760037337,1760037341
BUY,25240.5,25245.5,20,WIN,6,1760037341,1760037347
BUY,25245.5,25240.5,-20,LOSS,2,1760037347,1760037349
BUY,25240.75,25245.75,20,WIN,7,1760037349,1760037356
BUY,25245.5,25250.5,20,WIN,16,1760037356,1760037372
BUY,25250.5,25245.5,-20,LOSS,22,1760037372,1760037394
BUY,25243.5,25248.5,20,WIN,8,1760037394,1760037402
BUY,25248.5,25253.5,20,WIN,89,1760037402,1760037491
BUY,25253,25258.0,20,WIN,19,1760037491,1760037510
BUY,25258.25,25263.25,20,WIN,83,1760037576,1760037659
BUY,25262.25,25267.25,20,WIN,189,1760037704,1760037893
BUY,25265,25270.0,20,WIN,123,1760037941,1760038064
BUY,25267.25,25272.25,20,WIN,575,1760038106,1760038681
BUY,25276.75,25271.75,-20,LOSS,92,1760038756,1760038848
BUY,25272,25277.0,20,WIN,253,1760038848,1760039101
BUY,25276.25,25271.25,-20,LOSS,9,1760039101,1760039110
BUY,25271.25,25276.25,20,WIN,124,1760039110,1760039234
BUY,25276,25281.0,20,WIN,165,1760039234,1760039399
BUY,25279,25284.0,20,WIN,75,1760039435,1760039510
BUY,25283.5,25278.5,-20,LOSS,99,1760039575,1760039674
BUY,25278.5,25283.5,20,WIN,5,1760039674,1760039679
BUY,25283.25,25288.25,20,WIN,20,1760039682,1760039702
BUY,25284.25,25279.25,-20,LOSS,99,1760039732,1760039831
BUY,25280,25275.0,-20,LOSS,15,1760039831,1760039846
BUY,25275.5,25270.5,-20,LOSS,66,1760039846,1760039912
BUY,25271.75,25276.75,20,WIN,10,1760039912,1760039922
BUY,25276.5,25281.5,20,WIN,40,1760039922,1760039962
BUY,25281,25286.0,20,WIN,21,1760039962,1760039983
BUY,25290.75,25295.75,20,WIN,115,1760040043,1760040158
BUY,25295.75,25290.75,-20,LOSS,126,1760040247,1760040373
BUY,25290.75,25295.75,20,WIN,51,1760040373,1760040424
BUY,25295.75,25290.75,-20,LOSS,296,1760040425,1760040721
BUY,25291,25286.0,-20,LOSS,144,1760040721,1760040865
BUY,25286,25281.0,-20,LOSS,78,1760040865,1760040943
BUY,25281,25276.0,-20,LOSS,269,1760040943,1760041212
BUY,25276,25281.0,20,WIN,76,1760041212,1760041288
BUY,25281,25276.0,-20,LOSS,421,1760041288,1760041709
BUY,25276,25271.0,-20,LOSS,229,1760041709,1760041938
BUY,25270.75,25275.75,20,WIN,203,1760041938,1760042141
BUY,25276.5,25281.5,20,WIN,494,1760042141,1760042635
BUY,25281.75,25276.75,-20,LOSS,618,1760042635,1760043253
BUY,25276.75,25281.75,20,WIN,273,1760043253,1760043526
BUY,25282,25287.0,20,WIN,32,1760043526,1760043558
